걸음이 느린아이	고유진	SlVbNM1FMZo
괜찮아	DVWN	eAP5RZe-IDo
그런사람 또 없습니다	이승철	Jp4-snWZuoI
기억을 걷는 시간	넬	R6pVI4M_DZE
도망간 내 여자친구를 소개합니다	노라조	Yc_b0Hsbdac
만약에	태연	g72-wPkw-To
베르사이유의 장미	네메시스	hDzEA6CGG4U
사랑은 언제나 목마르다	유미	yr332PkY7Wo
잊지말아요	백지영	oKjT6LEOPxo
지켜줄게	백예린	IDD5_z3kKCU
Beautiful	크러쉬	bT7P0HCTXzI
BERMUDA TRIANGLE	지코	ZHoLaLlL5lA
Bounce	조용필	Du3rcfI9hDY
D	DEAN	eelfrHtmk68
Deemo Dream	Rabpit	9xdbhI3pqxY
Endless	플라워	HDnNVWTANgY
I Miss You	소유	t9KpdoSxVZU
Instagram	DEAN	wKyMIrBClYw
Love me more	dosii	CL34af5Y7cc
Miles	Electronic Boutique	2aBQOcZyTNg
No love no more	백지영	EAWHtXQpYX4
Pulse	하현우	QOpa9nFfMBA
Secret	Electronic Boutique	5CfszyKq2MY
This Love	다비치	u2Dqub2Xnhc
Viva La Vida	ColdPlay	R8UAFE21BN4
Wave	새소년	fqlStglcvII
Always	T윤미래	xyaKqWMpfIA
What to do	DEAN	gMrYfJGm7kM
		
한번만더	나얼	4OT8DYuni9Q
돌아가줘	브라운아이즈	JJkQ9TxCd_o
너를 위해	임재범	I6sd5vAxkkg
언제나 그랬죠	브라운아이즈	JGqCsEoAWjg
I love you	포지션	gqdQy6pyCy4
커피	브라운아이즈	y7gCktBEn5U
점점	브라운아이즈	ANE5j1zUExU
꿈에	dosii	ydlmygcZWLA
